4 4 4 4 4 4 4 4 4 4 4 4 4 4 4 4 4 4 4 4 4 4 4 4 4 4 4 4 4 4 4 4 2 2 2 2 2 2 2 2 2 2 2 2 2 2 2 2 2 2 
4 4 4 4 4 4 4 4 4 4 4 4 4 4 4 4 4 4 4 4 4 4 4 4 4 4 4 4 4 4 4 4 2 2 2 2 2 2 2 2 2 2 2 2 2 2 2 2 2 2 
4 4 1 1 1 1 1 1 1 4 4 4 4 1 1 1 1 1 1 1 4 4 4 4 4 4 4 4 4 4 4 4 2 2 2 2 2 2 2 2 2 2 2 2 2 2 2 2 2 2 
4 4 1 6 6 6 6 6 1 4 4 4 4 1 6 6 6 6 6 1 4 4 4 4 4 4 4 4 4 5 5 5 5 2 2 2 2 2 2 2 2 2 2 2 2 2 2 2 2 2 
4 4 1 6 6 6 6 6 1 4 4 4 4 1 6 6 6 6 6 1 4 4 4 4 4 4 4 4 4 5 5 5 5 2 2 2 2 2 2 2 2 2 2 2 2 2 2 2 2 2 
4 4 1 1 1 6 1 1 1 0 0 0 0 1 1 1 6 1 1 1 4 4 4 4 4 4 4 4 4 5 5 5 2 2 2 2 5 2 2 2 2 2 2 2 2 2 2 2 2 2 
4 4 4 0 0 3 0 0 0 0 0 0 0 0 0 0 3 0 0 4 4 4 4 4 4 4 4 4 4 5 5 5 2 2 2 2 5 2 2 2 2 2 2 2 2 2 2 2 2 2 
4 4 4 3 3 3 3 3 3 3 3 3 3 3 3 3 3 3 3 3 3 3 3 3 3 3 3 3 3 3 3 2 2 2 5 5 5 2 2 2 2 2 2 2 2 2 2 2 5 5
4 4 4 4 4 4 4 4 4 4 3 3 4 4 4 4 4 4 4 4 4 4 4 3 4 4 4 5 5 5 3 2 2 2 5 5 5 5 2 2 2 2 2 2 2 2 2 5 5 5  
4 4 4 4 4 4 4 4 4 4 3 3 4 4 4 4 4 4 4 4 4 4 4 3 4 4 4 5 2 2 3 2 2 5 5 5 5 5 2 2 2 2 2 2 5 5 5 5 5 5
4 4 4 4 4 4 4 4 4 4 3 3 4 4 4 4 4 4 4 4 4 4 4 3 4 4 5 5 2 2 3 2 2 5 5 5 5 5 2 2 2 2 2 2 5 5 5 5 5 5
4 4 4 4 4 4 4 4 4 4 3 3 4 4 4 4 4 4 4 4 4 4 4 3 4 4 5 2 2 2 3 5 5 5 5 5 5 5 5 5 5 5 5 5 5 5 5 5 5 5 
4 4 4 4 4 4 4 4 4 4 3 3 4 4 4 4 4 4 4 4 4 4 4 3 4 5 5 2 2 2 3 5 5 5 5 5 5 5 5 5 5 5 5 5 5 5 5 5 5 5 
4 4 4 4 4 4 4 4 4 4 3 3 4 4 4 4 4 4 4 4 4 4 4 3 4 5 2 2 2 2 3 3 3 3 3 3 3 3 3 3 3 3 3 3 3 3 3 3 3 3
4 4 4 4 4 4 4 4 4 4 3 3 3 3 3 3 4 4 4 4 4 4 4 3 5 5 2 2 2 5 5 3 4 4 4 4 4 4 4 4 4 4 4 4 4 4 4 4 4 4
4 4 4 4 4 4 4 4 4 4 3 3 3 3 3 3 4 4 4 4 4 4 4 3 5 2 2 2 5 5 5 3 4 4 4 4 4 4 4 4 4 4 4 4 4 4 4 4 4 4
4 4 4 4 4 4 4 4 4 4 4 4 4 4 3 3 4 4 4 4 4 4 4 3 5 2 2 2 5 4 4 3 4 4 4 4 4 4 4 4 4 4 4 4 4 4 4 4 4 4
4 4 1 1 1 1 1 1 1 1 1 1 4 4 3 3 4 4 4 4 4 4 4 3 5 2 2 2 5 4 4 3 4 4 4 4 4 4 4 4 4 4 4 4 4 4 4 4 4 4
4 4 1 6 6 6 6 6 6 6 6 1 4 4 3 3 4 4 4 4 4 4 4 3 5 2 2 2 5 4 4 3 4 4 4 4 4 4 4 4 4 4 4 4 4 4 4 4 4 4
4 4 1 6 6 6 6 6 6 6 6 1 4 4 3 3 4 4 4 4 4 4 4 3 5 2 2 2 5 4 4 3 4 4 4 4 4 4 4 1 1 1 1 1 1 1 4 4 4 4
4 4 1 6 6 6 6 6 6 6 6 1 4 4 3 3 4 4 4 4 4 4 4 3 5 2 2 2 5 4 4 3 4 4 4 4 4 4 4 1 6 6 6 6 6 1 4 4 4 4
4 4 1 1 1 1 6 6 1 1 1 1 4 4 3 3 4 4 4 4 4 4 4 3 5 2 2 2 5 4 4 3 4 4 4 4 4 4 4 1 6 6 6 6 6 1 4 4 4 4
4 4 4 4 4 0 3 3 0 4 4 4 4 4 3 3 4 4 4 4 4 4 4 3 5 2 2 2 5 4 4 3 4 4 4 4 4 4 4 1 1 1 6 1 1 1 4 4 4 4
4 4 4 4 4 0 3 3 0 4 4 4 4 4 3 3 4 4 4 4 4 4 4 3 5 2 2 2 5 4 4 3 4 4 4 4 4 4 4 4 4 4 3 4 4 4 4 4 4 4
4 4 4 4 4 4 3 3 4 4 4 4 4 4 3 3 4 4 4 4 4 4 4 3 5 2 2 2 5 4 4 3 4 4 4 4 4 4 4 4 4 4 3 4 4 4 4 4 4 4
4 4 4 4 4 4 3 3 3 3 3 3 3 3 3 3 3 3 3 3 3 3 3 3 5 2 2 2 5 4 4 3 3 3 3 3 3 3 3 3 3 3 3 4 4 4 4 4 4 4
4 4 4 4 4 4 4 4 4 4 4 4 4 4 4 4 4 4 4 4 4 4 4 5 5 2 2 2 5 4 4 4 4 4 4 4 4 4 4 4 4 4 4 4 4 4 4 4 4 4
4 4 4 4 4 4 4 4 4 4 4 4 4 4 4 4 4 4 4 4 4 4 4 5 2 2 2 5 5 4 4 4 4 4 4 4 4 4 4 4 4 4 4 4 4 4 4 4 4 4
4 4 4 4 4 4 4 4 4 4 4 4 4 4 4 4 4 4 4 4 4 4 4 5 2 2 5 5 0 4 4 4 4 4 4 4 4 4 4 4 4 4 4 4 4 4 4 4 4 4
4 4 4 4 4 4 4 4 4 4 4 4 4 4 4 4 4 4 4 4 4 4 4 5 2 5 5 0 0 4 4 4 4 4 4 4 4 4 4 4 4 4 4 4 4 4 4 4 4 4
4 4 4 4 4 4 4 4 4 4 4 4 4 4 4 4 4 4 4 4 4 4 4 5 5 5 0 0 0 4 4 4 4 4 4 4 4 4 4 4 4 4 4 4 4 4 4 4 4 4
4 4 4 0 0 0 0 0 0 0 0 0 0 0 0 0 0 0 0 0 0 0 0 0 0 0 0 0 0 4 4 4 4 4 4 4 4 4 4 4 4 4 4 4 4 4 4 4 4 4
4 4 4 0 0 0 0 0 0 0 0 0 0 0 0 0 0 0 0 0 0 0 0 0 0 0 0 0 0 4 4 4 4 4 4 4 4 4 4 4 4 4 4 4 4 4 4 4 4 4
4 4 4 0 0 4 4 4 4 4 4 4 4 4 4 4 4 4 4 4 4 4 4 4 4 4 4 4 0 4 4 4 4 4 4 4 4 4 4 4 4 4 4 4 4 4 4 4 4 4
4 4 4 3 3 3 3 3 3 3 3 3 3 3 3 3 3 3 3 3 3 3 3 3 3 3 3 3 3 4 4 4 4 4 4 4 4 4 4 4 4 4 4 4 4 4 4 4 4 4
4 4 4 3 4 4 4 4 4 4 4 4 4 4 4 3 4 4 4 4 4 4 4 4 4 4 4 4 3 4 4 4 4 4 4 4 4 4 4 4 4 4 4 4 4 4 4 4 4 4
4 4 4 3 4 4 4 4 4 4 4 4 4 4 4 3 4 4 4 4 4 4 4 4 4 4 4 4 3 3 3 3 3 3 3 3 3 4 4 4 4 4 4 4 4 4 4 4 4 4
4 4 4 3 4 4 4 4 4 4 4 4 4 4 4 3 4 4 4 4 4 4 4 4 4 4 4 4 4 4 4 4 4 4 4 4 3 4 4 4 4 4 4 4 4 4 4 4 4 4
4 4 4 3 4 4 4 4 4 4 4 4 4 4 4 3 4 4 4 4 4 4 4 4 4 4 4 4 4 4 4 4 4 4 4 4 3 4 4 4 4 4 4 4 4 4 4 4 4 4
4 4 4 3 4 4 4 4 4 4 4 4 4 4 4 3 4 4 4 4 4 4 4 4 4 4 4 4 4 4 4 4 4 4 4 4 3 4 4 4 4 4 4 4 4 4 4 4 4 4
4 4 4 3 4 4 4 4 4 4 4 4 4 4 4 3 4 4 4 4 4 4 4 4 4 4 4 4 4 4 4 4 4 4 4 4 3 4 4 4 4 4 4 4 4 4 4 4 2 2
4 4 4 3 4 4 4 4 4 4 4 4 4 4 3 3 3 4 4 4 4 4 4 4 4 4 4 4 4 4 4 4 4 4 4 4 3 4 4 4 4 4 4 4 4 4 4 2 2 2
4 4 4 3 4 4 4 4 4 4 4 4 4 4 4 4 4 4 4 4 4 4 4 4 4 4 4 4 4 4 4 4 4 4 4 4 3 4 4 4 4 4 4 4 4 4 2 2 2 4
4 4 4 3 4 4 4 4 4 4 4 4 4 4 4 4 4 4 4 4 4 4 4 4 1 1 1 1 1 1 1 4 4 4 4 4 3 3 3 5 5 5 5 5 4 2 2 2 4 4
4 4 4 3 4 4 4 4 4 4 4 4 4 4 4 4 4 4 4 4 4 4 4 4 1 6 6 6 6 6 1 4 4 4 4 4 4 4 3 5 5 5 5 5 2 2 2 4 4 4
4 4 3 3 3 4 4 4 4 4 4 4 4 4 4 4 4 4 4 4 4 4 4 4 1 6 6 6 6 6 1 4 4 4 4 4 4 4 3 5 5 5 5 5 2 2 4 4 4 4
4 4 3 3 3 3 3 3 3 3 3 3 3 3 3 3 3 3 3 3 3 3 3 4 1 1 1 6 1 1 1 4 4 4 4 4 4 4 3 4 4 4 4 4 4 4 4 4 4 4
4 4 3 3 3 4 4 4 4 4 4 4 4 4 4 4 4 4 4 4 4 4 3 4 4 4 0 3 0 4 4 4 4 4 4 4 4 4 3 4 4 4 4 4 4 4 4 4 4 4
4 4 4 4 4 4 4 4 4 4 4 4 4 4 4 4 4 4 4 4 4 4 3 3 3 3 3 3 0 4 4 4 4 4 4 4 4 4 4 4 4 4 4 4 4 4 4 4 4 4
4 4 4 4 4 4 4 4 4 4 4 4 4 4 4 4 4 4 4 4 4 4 4 4 4 4 4 4 4 4 4 4 4 4 4 4 4 4 4 4 4 4 4 4 4 4 4 4 4 4